CaseID,TVchildBR,compchildBR,tabletchildBR,cellchildBR,gamechildBR,mp3childBR,count
180,2,1,2,1,2,1,9
1027,2,2,2,2,2,2,12
635,1,2,2,1,1,1,8
3,1,2,1,1,1,1,7
265,1,1,1,2,2,1,8
1091,2,2,1,2,1,1,9
30,2,2,2,2,2,2,12
263,1,2,1,1,1,1,7
486,1,2,2,2,1,1,9
490,2,1,2,1,1,1,8
877,1,1,1,1,1,1,6
1146,2,2,2,2,2,1,11
1206,1,2,1,1,2,1,8
1282,1,2,2,2,1,1,9
1316,2,1,1,1,2,1,8
1426,1,2,2,2,2,2,11
1430,2,1,2,2,1,1,9
402,2,2,2,2,2,2,12
526,2,2,2,2,2,2,12
563,1,1,1,1,1,1,6
582,1,1,2,2,1,1,8
757,1,2,1,1,2,1,8
977,2,2,2,2,2,2,12
990,2,1,1,1,2,2,9
1184,1,2,2,2,2,2,11
322,2,2,2,2,2,2,12
397,2,2,1,2,1,1,9
819,2,1,2,1,2,2,10
943,2,2,1,2,2,2,11
992,1,2,2,1,2,2,10
1142,2,2,2,2,2,2,12
1158,1,1,1,1,1,1,6
1245,1,2,2,1,2,2,10
1512,1,2,1,2,1,2,9
852,2,2,2,2,2,1,11
572,2,2,2,2,2,2,12
532,1,1,1,2,1,1,7
377,2,2,1,2,2,1,10
261,1,2,1,1,1,1,7
314,1,1,2,1,2,1,8
437,1,2,2,1,2,1,9
1050,2,2,2,2,2,2,12
612,2,2,1,2,2,1,10
670,1,1,1,1,1,2,7
1185,2,2,2,2,2,2,12
1363,2,2,1,2,2,2,11
1391,1,2,2,2,2,2,11
128,2,2,2,2,2,1,11
216,1,2,2,2,2,2,11
507,1,2,2,2,2,2,11
528,2,2,2,2,2,2,12
678,1,2,2,2,2,1,10
727,1,1,1,2,2,2,9
740,2,2,2,2,2,1,11
751,2,2,2,2,2,2,12
811,1,2,2,2,2,2,11
870,1,2,2,2,1,2,10
889,2,2,2,1,2,2,11
981,2,2,2,2,2,1,11
1018,2,2,2,1,2,1,10
1125,1,2,1,2,1,1,8
1252,1,1,2,1,1,1,7
1255,2,2,2,2,2,1,11
1264,2,1,2,1,1,1,8
1297,1,1,1,2,1,2,8
1482,2,1,2,2,2,1,10
1485,2,2,2,2,2,2,12
1527,1,2,1,2,1,2,9
8,1,1,1,1,1,1,6
209,2,2,2,2,2,2,12
248,2,2,2,2,2,2,12
367,2,2,2,2,2,1,11
475,2,2,2,2,2,1,11
529,2,2,2,2,2,2,12
592,1,2,2,2,2,2,11
648,1,2,2,1,1,2,9
792,1,2,2,2,2,2,11
939,1,2,2,2,2,2,11
948,2,2,2,2,2,2,12
968,2,2,2,2,2,2,12
1026,2,2,2,2,2,2,12
1161,2,2,2,2,2,2,12
1220,1,2,2,2,2,2,11
1263,2,2,2,2,2,2,12
1289,1,1,2,2,2,1,9
1343,1,2,1,1,2,2,9
1416,1,1,2,2,1,1,8
1513,1,1,1,1,1,1,6
326,2,2,2,2,2,1,11
408,2,2,2,2,2,2,12
619,1,2,2,2,1,2,10
643,2,2,2,2,2,2,12
679,2,2,2,2,2,2,12
768,2,2,2,2,2,2,12
806,2,2,2,2,2,2,12
857,2,2,2,2,2,1,11
925,2,2,2,2,2,2,12
928,2,2,2,2,2,1,11
1165,2,2,2,2,2,1,11
1200,2,2,2,2,2,1,11
1472,2,2,2,2,2,2,12
1537,2,2,2,2,2,2,12
1133,2,2,1,2,2,1,10
1189,1,2,1,2,1,2,9
17,1,1,1,1,1,1,6
23,2,1,1,2,2,2,10
75,2,1,2,1,2,1,9
150,1,1,1,2,2,2,9
318,2,1,1,1,1,2,8
350,2,1,2,1,2,2,10
500,1,2,1,2,2,2,10
684,2,1,1,1,2,1,8
851,2,1,2,1,2,1,9
1075,1,1,1,2,1,1,7
1078,1,2,1,1,1,1,7
1173,1,1,2,1,1,1,7
1397,1,1,1,2,1,1,7
1419,2,2,2,2,2,1,11
1439,1,2,1,1,2,1,8
94,1,2,1,1,1,1,7
123,1,1,1,1,2,1,7
139,2,2,2,2,2,2,12
179,1,1,1,2,1,1,7
184,2,2,1,1,2,1,9
190,2,2,1,1,2,2,10
259,1,1,1,2,2,1,8
316,2,2,1,1,2,1,9
346,2,1,2,2,2,1,10
348,1,1,2,1,1,1,7
385,1,2,1,1,2,1,8
419,1,1,2,1,1,1,7
433,2,1,1,2,2,1,9
480,1,2,1,2,2,2,10
494,1,2,2,2,2,2,11
541,1,2,2,1,1,2,9
553,2,1,2,1,2,1,9
558,1,2,1,1,2,2,9
600,1,1,2,2,2,1,9
674,1,2,2,2,2,2,11
715,1,1,1,1,1,1,6
716,1,2,1,2,2,2,10
726,1,1,2,1,2,2,9
733,1,2,2,2,2,2,11
753,2,1,1,1,1,2,8
787,1,1,1,1,1,1,6
794,2,2,1,2,2,1,10
846,2,1,2,1,2,2,10
904,1,1,1,1,1,1,6
908,2,2,1,2,2,2,11
947,1,2,2,2,2,2,11
958,1,2,2,2,2,2,11
969,2,2,2,2,2,1,11
1006,1,2,2,1,2,2,10
1024,1,1,2,2,2,1,9
1064,1,1,1,1,1,1,6
1159,2,2,1,1,1,1,8
1193,1,2,2,2,2,1,10
1207,1,2,2,1,1,1,8
1257,2,2,2,1,2,2,11
1274,1,1,2,2,2,1,9
1287,2,2,1,2,2,2,11
1326,1,2,1,2,2,2,10
1352,2,1,2,1,2,2,10
1417,1,1,1,1,1,1,6
1425,1,1,1,2,1,1,7
1447,2,2,1,1,1,1,8
1456,1,2,2,2,1,2,10
1477,2,2,2,2,2,1,11
1494,1,1,1,2,2,2,9
6,2,2,2,2,2,2,12
11,2,2,2,1,2,2,11
15,1,1,1,2,2,1,8
29,2,1,1,1,1,1,7
40,1,1,1,2,2,1,8
45,2,1,1,1,2,1,8
54,1,2,2,2,1,1,9
59,2,2,1,2,2,2,11
76,1,2,2,2,2,2,11
89,2,2,2,2,2,1,11
95,1,1,2,1,1,1,7
115,1,2,2,1,1,1,8
121,2,2,1,2,1,2,10
177,2,2,2,2,2,2,12
181,1,2,1,2,2,1,9
187,2,1,1,1,2,1,8
239,1,2,2,1,1,1,8
276,2,2,2,2,2,1,11
278,1,2,2,2,1,2,10
281,1,1,1,2,1,2,8
319,2,2,1,1,2,1,9
335,2,2,2,2,2,2,12
341,1,2,2,2,2,1,10
351,2,1,2,2,1,1,9
401,2,2,2,2,2,2,12
451,2,1,2,1,2,2,10
455,2,1,1,2,2,1,9
476,1,2,2,1,1,1,8
478,2,2,1,2,2,1,10
493,1,2,2,2,2,2,11
545,2,1,1,2,2,2,10
564,2,2,2,1,2,1,10
583,2,2,1,1,2,1,9
585,1,2,2,2,2,2,11
602,1,1,1,2,1,1,7
649,1,1,1,1,1,1,6
651,1,2,2,1,2,2,10
708,2,2,2,1,1,1,9
720,1,2,2,2,2,2,11
724,1,2,2,2,2,2,11
725,1,2,2,2,2,2,11
773,1,2,1,1,2,2,9
803,2,2,2,2,2,1,11
822,1,2,1,2,1,2,9
834,1,2,1,1,1,1,7
838,1,1,1,1,1,1,6
863,2,2,2,2,2,2,12
864,2,2,1,2,2,2,11
882,2,2,2,2,2,1,11
886,2,2,2,2,2,2,12
893,1,2,2,2,2,2,11
895,1,2,2,1,2,2,10
917,1,2,2,2,2,2,11
919,2,2,1,2,2,1,10
920,2,1,1,2,2,2,10
923,2,2,1,2,2,2,11
930,2,2,2,2,2,2,12
940,1,2,2,1,1,2,9
945,2,1,1,2,2,2,10
953,1,2,2,1,2,1,9
955,2,2,1,2,2,2,11
963,1,1,2,1,2,2,9
994,2,2,2,2,2,2,12
1015,1,2,2,2,2,2,11
1039,2,1,1,1,2,1,8
1058,1,1,2,2,2,2,10
1067,1,2,2,2,1,1,9
1077,1,2,2,2,2,2,11
1090,2,2,1,2,2,1,10
1099,1,2,2,2,1,2,10
1117,2,2,1,2,1,1,9
1131,2,1,2,2,2,1,10
1136,2,2,1,2,2,2,11
1160,1,2,2,1,1,2,9
1210,2,2,2,1,2,1,10
1225,2,1,2,2,2,1,10
1240,1,2,1,2,1,1,8
1254,2,2,2,2,2,2,12
1276,1,1,2,1,1,1,7
1277,1,2,2,2,1,2,10
1296,1,2,2,2,2,2,11
1305,2,2,2,2,2,2,12
1315,1,2,2,2,1,2,10
1328,1,2,2,2,2,1,10
1329,2,2,2,1,2,2,11
1335,2,2,2,2,2,2,12
1339,1,2,1,2,2,2,10
1349,2,2,1,2,2,1,10
1358,1,1,2,2,1,2,9
1377,2,2,1,2,2,2,11
1401,2,2,2,1,2,1,10
1418,2,2,2,2,2,2,12
1453,1,1,1,2,1,1,7
1457,1,2,2,2,1,2,10
1460,2,2,2,1,2,2,11
1471,1,2,2,2,2,2,11
1510,1,1,2,1,2,2,9
1522,2,1,1,1,2,1,8
1524,1,1,1,1,1,1,6
1530,1,1,1,1,2,2,8
2,2,2,2,2,2,2,12
5,2,2,2,2,2,2,12
21,2,2,1,2,2,2,11
83,1,2,2,2,1,1,9
88,2,2,2,2,2,2,12
100,1,2,1,2,1,1,8
129,2,2,2,2,2,2,12
154,2,2,2,2,2,2,12
159,1,2,1,2,2,2,10
178,2,2,2,2,2,2,12
194,1,2,1,2,1,1,8
232,1,2,2,2,2,1,10
241,2,2,2,2,2,2,12
242,2,2,1,2,1,1,9
257,1,2,2,2,1,2,10
268,2,2,2,2,2,1,11
294,2,2,2,2,2,2,12
303,2,1,1,2,1,1,8
306,2,2,2,2,2,2,12
307,2,2,2,2,2,2,12
320,1,2,2,2,2,2,11
329,1,2,1,1,1,1,7
339,1,2,2,2,2,1,10
340,1,1,1,1,1,1,6
344,2,2,1,2,2,2,11
362,2,2,1,2,2,2,11
363,2,2,1,2,2,2,11
389,1,2,2,2,2,2,11
392,1,2,2,2,2,1,10
395,1,1,2,2,1,1,8
435,2,2,1,2,2,2,11
450,2,2,2,2,2,2,12
515,2,2,2,2,2,1,11
520,2,2,2,1,2,2,11
542,1,1,1,1,1,1,6
567,2,1,1,1,2,1,8
577,1,2,2,2,2,2,11
596,2,1,1,1,2,1,8
625,2,2,2,2,2,2,12
641,1,2,1,2,1,2,9
682,2,2,2,2,2,1,11
685,1,1,2,2,2,2,10
691,2,2,2,2,2,2,12
744,1,2,2,2,2,2,11
745,1,2,2,2,2,2,11
748,2,2,2,2,2,2,12
816,2,2,2,2,2,2,12
830,1,2,2,2,2,2,11
847,2,2,2,2,2,2,12
892,2,2,2,2,2,2,12
894,1,2,1,2,2,1,9
898,1,2,1,2,2,2,10
911,2,2,1,1,2,2,10
914,1,2,1,1,2,1,8
980,1,2,1,1,2,1,8
987,1,2,2,2,2,2,11
1001,1,1,1,1,2,1,7
1014,2,1,2,1,2,2,10
1016,2,2,2,2,2,2,12
1055,1,2,2,2,1,1,9
1061,1,2,2,2,2,1,10
1065,2,2,2,2,2,2,12
1123,2,2,2,1,2,1,10
1130,2,2,2,2,2,2,12
1143,2,2,1,2,2,1,10
1154,1,2,2,1,2,2,10
1166,2,2,2,2,2,2,12
1198,1,1,1,1,2,1,7
1201,2,2,1,2,1,1,9
1218,2,2,2,2,2,2,12
1237,1,2,1,2,2,1,9
1258,1,2,2,2,2,2,11
1265,2,2,2,2,2,2,12
1310,1,1,1,2,1,2,8
1313,2,1,1,1,1,1,7
1370,2,1,1,2,1,2,9
1375,1,2,2,2,2,1,10
1386,1,2,2,2,2,1,10
1403,2,2,2,2,2,1,11
1405,1,2,1,2,2,2,10
1427,2,2,2,2,2,2,12
1451,2,2,2,2,2,1,11
1486,1,2,2,2,2,1,10
1543,1,1,1,1,1,1,6
7,2,2,2,2,2,2,12
20,2,2,2,2,2,2,12
33,2,2,2,2,2,1,11
35,1,2,1,1,2,1,8
44,2,2,2,2,2,1,11
46,1,2,2,1,1,1,8
58,2,2,2,2,2,1,11
69,2,2,2,2,2,2,12
80,1,2,2,2,2,2,11
141,2,2,2,2,2,2,12
146,2,2,2,2,2,2,12
147,2,2,2,2,2,2,12
174,2,2,2,2,2,2,12
197,2,2,2,2,2,2,12
213,1,2,1,1,2,2,9
220,2,2,2,2,2,1,11
224,2,2,2,2,2,2,12
252,2,2,2,2,2,1,11
267,2,2,2,2,2,2,12
331,2,2,2,2,2,2,12
396,2,2,2,2,2,2,12
403,2,2,2,2,2,2,12
405,2,2,2,2,2,2,12
413,1,1,1,1,1,1,6
420,2,2,2,2,2,1,11
427,2,2,2,2,2,2,12
454,2,2,2,2,2,2,12
470,2,2,2,2,2,1,11
508,2,2,2,2,2,2,12
513,2,2,1,2,2,1,10
524,2,2,2,2,2,2,12
551,2,2,2,2,2,2,12
575,2,2,2,2,2,2,12
609,2,1,1,2,1,1,8
610,1,1,1,1,1,2,7
617,2,2,2,2,2,2,12
628,2,2,2,2,2,2,12
634,1,2,1,2,2,2,10
694,1,2,2,2,2,2,11
746,2,2,2,2,2,2,12
770,2,2,2,2,2,2,12
779,1,2,2,2,2,2,11
788,2,2,2,2,2,2,12
835,2,2,2,2,1,2,11
836,2,2,2,2,1,2,11
860,2,2,2,2,2,2,12
865,2,2,2,2,2,2,12
873,1,2,2,2,2,2,11
900,2,2,2,2,2,2,12
910,1,2,2,2,2,2,11
915,2,2,2,2,2,2,12
927,2,2,2,2,2,2,12
931,1,2,2,2,1,1,9
1007,2,2,2,2,1,2,11
1009,2,2,2,2,2,2,12
1054,2,2,2,2,2,2,12
1108,2,2,2,2,2,2,12
1115,2,2,2,2,2,2,12
1119,2,2,2,2,2,2,12
1126,2,2,2,2,2,2,12
1134,1,1,2,1,2,2,9
1140,2,2,2,2,2,2,12
1194,2,2,2,2,2,2,12
1202,1,1,2,2,2,2,10
1204,2,2,2,1,2,2,11
1208,2,2,2,2,2,1,11
1234,2,2,2,2,2,1,11
1268,2,2,2,2,2,2,12
1300,2,2,2,1,1,1,9
1334,1,1,1,2,2,2,9
1351,2,2,2,2,2,2,12
1360,1,1,1,2,1,1,7
1380,1,2,2,2,1,2,10
1404,2,2,2,2,2,2,12
1413,1,2,1,2,2,1,9
1432,2,2,2,2,2,2,12
1433,2,2,2,2,1,1,10
1436,1,2,2,2,2,2,11
1438,2,2,2,2,2,2,12
1487,1,2,2,2,2,2,11
1492,1,2,2,2,2,2,11
1502,2,2,2,2,2,2,12
1531,1,2,1,2,2,1,9
1540,2,2,1,2,2,2,11
106,1,2,2,2,1,1,9
370,2,2,2,2,2,1,11
790,2,2,2,2,2,2,12
1167,1,2,1,2,1,2,9
458,2,2,2,2,2,2,12
13,1,1,2,1,1,1,7
10,1,1,1,1,1,1,6
122,2,1,1,2,2,1,9
388,2,1,2,2,2,1,10
534,1,1,1,1,2,1,7
615,2,1,1,1,1,2,8
901,1,1,1,2,2,2,9
978,1,2,2,2,2,1,10
1501,1,1,2,1,2,2,9
55,1,1,2,1,2,1,8
73,2,2,1,2,2,1,10
90,1,1,2,2,2,2,10
120,2,1,1,2,2,2,10
149,1,1,2,1,1,2,8
160,2,2,2,2,2,2,12
168,1,1,2,1,1,1,7
205,2,2,1,2,2,1,10
223,1,2,2,1,2,1,9
251,2,1,2,1,2,2,10
253,1,1,2,1,2,2,9
286,2,1,1,2,1,2,9
295,2,2,2,2,2,2,12
298,2,1,1,1,2,1,8
349,1,1,2,1,2,1,8
366,1,2,1,2,2,1,9
400,2,1,2,1,2,2,10
442,1,2,1,2,1,1,8
466,2,2,2,1,2,1,10
504,2,2,1,2,2,1,10
540,1,2,1,1,1,1,7
554,1,1,1,1,2,1,7
557,2,2,2,1,2,1,10
671,1,1,2,1,2,2,9
714,1,1,1,2,1,2,8
760,1,2,2,2,2,1,10
801,2,2,2,1,2,2,11
861,1,1,2,2,1,1,8
884,2,2,2,1,2,1,10
979,1,2,2,1,1,2,9
985,2,2,1,2,2,1,10
1043,2,1,2,1,1,1,8
1045,2,2,1,1,2,1,9
1060,1,2,2,1,2,2,10
1097,2,1,1,1,2,1,8
1116,1,1,1,1,1,1,6
1229,2,2,2,1,2,1,10
1247,1,2,1,2,1,2,9
1256,1,2,2,2,2,2,11
1298,2,2,1,2,2,2,11
1324,2,2,2,1,2,1,10
1346,1,2,1,2,1,2,9
1381,2,1,2,2,2,1,10
1382,1,2,2,2,1,2,10
1444,1,1,1,1,1,1,6
1505,2,2,2,2,2,1,11
14,1,2,2,2,2,2,11
18,2,1,1,1,2,2,9
39,2,2,2,2,2,1,11
51,2,2,2,2,2,1,11
62,2,1,1,2,2,1,9
79,1,2,2,2,1,1,9
136,2,2,2,2,2,1,11
137,2,2,2,2,1,1,10
152,1,2,1,2,2,1,9
153,2,2,2,2,2,2,12
212,2,2,1,2,2,1,10
262,2,2,2,2,2,2,12
266,1,2,2,2,2,2,11
269,2,1,2,1,2,1,9
273,2,2,2,2,2,2,12
274,2,2,2,2,2,1,11
285,2,2,1,2,2,1,10
291,2,2,2,2,2,2,12
302,1,2,2,2,2,2,11
309,2,2,2,1,2,1,10
321,2,2,2,2,2,1,11
343,2,2,2,2,1,2,11
372,2,1,1,2,1,1,8
375,2,2,2,2,2,1,11
383,2,2,2,2,2,1,11
394,2,2,2,2,2,2,12
448,2,1,1,2,1,1,8
462,2,2,2,1,2,2,11
464,2,2,1,2,1,2,10
474,2,2,1,2,1,1,9
509,2,2,2,2,2,2,12
510,1,1,1,2,1,1,7
517,1,1,2,2,1,1,8
556,2,2,1,1,2,2,10
568,1,1,1,1,2,2,8
571,1,2,2,2,2,2,11
587,1,2,2,2,2,2,11
594,1,2,1,2,2,1,9
606,2,2,1,2,2,1,10
608,1,1,2,1,2,1,8
629,1,2,1,2,2,1,9
632,1,2,1,2,1,1,8
640,1,1,2,1,2,2,9
687,2,2,1,2,2,2,11
701,1,2,2,2,2,2,11
707,1,2,2,2,2,2,11
710,1,2,1,1,2,1,8
712,1,1,1,1,1,1,6
741,1,2,1,2,1,1,8
782,1,2,2,2,2,2,11
784,2,2,2,1,2,1,10
805,1,2,1,2,1,2,9
814,2,2,2,2,2,1,11
825,2,2,2,2,2,2,12
843,1,1,2,1,1,1,7
853,2,2,2,2,2,1,11
869,2,2,1,1,2,1,9
874,2,2,2,2,2,1,11
878,1,2,2,2,2,2,11
890,1,1,1,2,2,1,8
899,2,1,1,1,2,1,8
905,1,2,2,1,2,1,9
926,2,2,1,2,2,2,11
942,2,2,1,1,2,1,9
959,2,1,2,1,2,2,10
971,2,2,2,2,2,2,12
973,1,1,1,1,1,1,6
999,2,1,2,2,2,1,10
1004,2,2,1,2,1,1,9
1005,2,2,2,2,2,2,12
1028,1,2,2,2,1,1,9
1034,1,1,2,1,1,1,7
1035,2,2,1,2,2,2,11
1056,1,2,1,1,2,1,8
1059,1,1,1,1,2,2,8
1071,1,2,2,2,1,1,9
1074,2,2,2,1,2,2,11
1080,2,1,2,2,2,1,10
1092,2,2,2,2,2,2,12
1093,1,2,2,1,2,2,10
1103,2,2,2,2,2,2,12
1112,2,2,2,2,2,2,12
1114,1,1,1,1,2,2,8
1118,2,2,2,2,2,2,12
1132,1,1,1,1,1,1,6
1135,2,1,2,2,2,2,11
1180,1,-1,1,2,2,2,7
1209,2,2,2,2,2,1,11
1212,2,2,2,2,2,2,12
1215,2,2,1,1,2,1,9
1226,2,1,2,1,2,1,9
1241,1,2,2,1,2,1,9
1243,2,2,1,2,2,2,11
1251,2,2,2,1,2,1,10
1253,1,2,1,2,2,2,10
1259,1,2,1,2,2,1,9
1306,1,2,2,2,2,2,11
1308,1,2,2,1,1,1,8
1342,2,2,2,2,2,1,11
1347,2,2,2,2,2,1,11
1353,1,2,2,2,1,2,10
1366,2,1,2,2,1,1,9
1385,1,2,2,2,1,1,9
1387,1,2,2,2,2,2,11
1396,2,2,2,2,2,2,12
1402,1,1,2,1,1,1,7
1434,2,2,2,2,1,1,10
1458,2,1,2,1,2,2,10
1479,2,2,1,1,2,2,10
1481,1,1,1,1,1,1,6
1500,2,1,2,1,2,1,9
1518,1,2,2,2,1,1,9
4,2,2,2,2,2,2,12
19,1,2,2,2,1,2,10
24,1,2,2,2,2,2,11
27,2,2,2,2,2,2,12
61,1,2,1,2,1,1,8
65,2,1,2,2,2,2,11
70,2,2,2,2,2,2,12
74,2,2,2,1,2,2,11
81,2,2,1,2,1,2,10
82,1,2,2,2,2,2,11
85,2,2,2,2,2,1,11
102,1,2,1,1,2,1,8
108,1,2,2,1,2,1,9
111,2,2,2,2,2,2,12
112,1,2,2,2,2,1,10
113,2,2,2,2,2,2,12
127,2,2,2,2,2,2,12
144,2,2,2,2,2,1,11
145,2,2,2,2,2,2,12
156,2,2,2,2,2,2,12
163,2,2,2,2,2,2,12
164,1,1,1,1,1,1,6
165,2,2,2,2,2,1,11
175,2,2,2,2,2,1,11
200,2,2,2,2,2,1,11
203,1,2,2,1,1,1,8
217,2,2,2,2,2,2,12
219,2,2,2,2,2,2,12
226,1,2,2,2,2,1,10
270,1,2,2,2,1,2,10
289,1,2,2,2,2,2,11
296,2,2,2,2,2,2,12
301,1,2,1,2,1,2,9
310,2,2,2,2,2,1,11
313,2,2,2,1,2,2,11
315,2,1,2,2,2,2,11
327,1,2,2,2,1,2,10
347,1,2,2,2,1,2,10
356,2,2,2,2,2,2,12
360,2,2,2,2,2,2,12
369,2,2,2,2,2,1,11
381,2,2,2,2,2,1,11
406,2,2,2,2,2,2,12
439,2,2,2,2,2,2,12
446,2,2,2,2,2,2,12
471,2,2,1,2,2,1,10
483,2,2,2,2,2,2,12
498,1,2,2,2,1,2,10
512,2,2,2,2,2,2,12
527,2,2,1,2,2,1,10
539,1,1,1,1,1,2,7
544,2,2,2,2,2,1,11
547,2,1,2,2,2,2,11
559,2,2,2,2,1,1,10
566,2,2,2,2,2,2,12
604,2,2,2,2,2,2,12
623,2,1,2,2,2,1,10
647,2,2,1,2,2,2,11
650,1,2,2,2,2,2,11
653,1,2,1,2,2,1,9
665,2,2,2,2,2,1,11
667,2,2,2,2,2,2,12
676,2,2,2,2,2,2,12
689,2,2,2,2,2,2,12
693,1,1,2,2,1,2,9
696,2,2,2,2,2,2,12
704,1,2,1,2,2,1,9
706,2,2,2,2,2,2,12
721,1,1,2,1,2,2,9
735,2,2,2,2,2,2,12
742,2,2,2,2,2,2,12
750,2,2,2,2,2,2,12
759,2,2,2,2,2,2,12
767,1,2,2,2,2,2,11
774,2,2,2,2,2,2,12
777,2,2,2,2,2,2,12
780,1,2,2,2,2,2,11
786,2,2,2,2,2,1,11
795,1,2,2,2,1,2,10
800,1,2,2,2,2,2,11
812,1,2,2,2,1,1,9
813,2,1,2,2,2,2,11
826,2,2,2,2,2,2,12
833,2,2,2,2,2,2,12
844,2,1,2,2,1,1,9
850,2,2,2,1,2,1,10
854,2,2,2,2,2,2,12
866,1,1,2,2,1,2,9
907,2,2,2,2,2,2,12
913,2,2,2,2,2,2,12
918,2,2,2,2,2,2,12
922,1,2,2,2,2,2,11
935,1,2,2,2,2,1,10
938,2,2,2,2,2,2,12
983,2,1,1,2,2,2,10
1017,1,1,2,1,2,1,8
1030,2,2,2,2,2,1,11
1041,1,2,1,1,2,2,9
1042,2,2,2,2,2,2,12
1048,2,2,2,2,2,1,11
1057,1,2,2,2,1,2,10
1069,2,2,2,2,2,2,12
1072,2,2,2,2,2,1,11
1098,2,2,2,2,2,2,12
1109,1,2,2,2,2,1,10
1129,1,2,2,2,2,2,11
1149,2,2,2,2,2,2,12
1168,2,2,2,2,2,2,12
1170,2,2,2,2,2,2,12
1174,2,2,2,2,2,1,11
1219,2,2,2,2,2,1,11
1261,1,1,2,1,1,1,7
1267,2,2,2,2,2,2,12
1271,2,2,2,2,2,2,12
1281,2,2,2,2,2,2,12
1284,2,2,2,2,2,2,12
1307,2,2,2,2,2,2,12
1309,1,2,1,2,2,1,9
1317,2,2,2,2,2,1,11
1321,2,2,1,2,1,2,10
1331,2,2,2,2,2,1,11
1345,1,2,1,2,2,2,10
1364,2,1,2,2,1,1,9
1399,1,2,2,2,2,1,10
1412,2,2,2,2,2,2,12
1415,2,2,2,2,2,1,11
1422,2,2,1,2,2,1,10
1440,1,2,2,2,2,2,11
1442,2,2,2,2,2,1,11
1448,2,2,1,2,2,2,11
1449,1,2,2,1,2,2,10
1463,2,2,2,2,2,1,11
1467,2,2,2,2,2,2,12
1475,2,2,2,2,2,2,12
1491,2,2,2,2,2,2,12
1506,2,2,2,1,2,1,10
1523,2,2,2,2,2,2,12
1533,2,2,2,2,2,2,12
1544,2,2,2,2,2,2,12
52,2,2,2,2,2,2,12
96,2,2,2,2,2,2,12
210,2,2,2,2,2,2,12
282,2,2,2,2,2,2,12
284,1,2,1,2,1,2,9
317,2,2,2,2,2,2,12
399,2,2,2,2,2,1,11
411,1,2,2,2,2,2,11
573,2,2,2,2,2,2,12
578,2,1,2,2,2,2,11
622,1,2,2,2,2,2,11
717,2,2,2,2,2,2,12
769,2,2,2,2,2,1,11
824,2,2,2,2,2,2,12
876,1,2,2,2,2,2,11
941,2,1,2,2,2,2,11
974,2,2,2,2,2,2,12
1044,1,2,2,2,1,2,10
1076,2,2,2,2,2,1,11
1139,1,2,2,2,1,1,9
1152,2,2,2,2,2,1,11
1155,2,2,2,2,2,2,12
1176,2,2,2,2,2,1,11
1188,1,2,2,2,1,2,10
1302,2,2,2,2,2,1,11
1314,2,2,2,2,2,2,12
1389,1,2,1,2,1,1,8
1443,1,2,2,2,1,2,10
1545,1,2,1,2,1,1,8
603,2,2,2,2,2,1,11
944,2,2,2,2,2,2,12
68,1,2,2,1,1,1,8
287,1,2,1,2,1,2,9
718,2,2,1,2,1,1,9
820,2,2,1,1,2,2,10
888,2,2,2,2,2,2,12
1435,1,1,1,2,1,1,7
250,1,2,1,1,1,1,7
280,1,2,2,1,2,2,10
415,1,1,1,1,2,1,7
467,1,1,1,2,2,2,9
700,2,2,2,1,2,2,11
722,1,2,2,2,2,2,11
728,2,2,2,1,2,2,11
761,2,1,2,1,2,1,9
856,1,1,2,2,1,1,8
906,1,2,2,2,1,2,10
964,1,1,1,2,1,2,8
1032,2,2,2,1,2,1,10
1246,1,2,2,1,2,2,10
1318,1,2,2,1,2,2,10
1330,1,2,2,1,2,1,9
1361,1,2,2,2,2,2,11
1390,1,2,1,2,1,1,8
1398,2,1,1,2,2,1,9
1431,2,2,2,2,2,2,12
1466,1,2,2,2,2,2,11
34,1,2,1,2,2,2,10
86,1,2,2,2,1,1,9
105,2,1,1,2,2,2,10
109,2,2,1,2,2,2,11
148,1,1,1,1,1,1,6
204,1,2,1,2,2,1,9
231,2,2,2,2,2,1,11
255,1,1,1,2,2,1,8
256,2,2,2,1,2,1,10
264,2,1,1,2,2,1,9
290,2,2,2,2,2,1,11
336,2,1,1,1,1,2,8
355,1,1,2,2,2,2,10
358,2,2,2,1,2,1,10
384,1,2,1,1,1,1,7
410,2,2,1,2,2,1,10
425,2,2,2,2,2,2,12
429,2,2,2,2,2,2,12
465,1,2,2,2,2,1,10
536,2,2,1,2,2,1,10
538,2,2,2,1,2,1,10
549,1,2,2,2,2,2,11
581,1,1,2,1,2,1,8
586,2,2,2,2,2,2,12
597,2,2,2,1,1,2,10
618,2,1,1,2,2,2,10
627,2,2,2,2,2,1,11
697,2,2,2,1,2,1,10
781,2,2,2,2,2,1,11
829,2,2,1,1,2,1,9
921,1,1,2,1,1,1,7
1012,2,2,2,2,2,2,12
1046,2,1,1,2,2,1,9
1047,1,2,2,1,1,1,8
1053,1,1,1,1,1,1,6
1062,2,2,2,2,2,2,12
1066,2,2,2,2,2,2,12
1106,2,2,1,1,1,2,9
1121,2,2,1,2,2,1,10
1211,2,2,2,2,2,2,12
1272,1,2,2,1,2,2,10
1311,1,2,1,1,2,1,8
1495,2,2,2,2,2,2,12
12,2,1,2,2,2,2,11
31,1,2,2,2,2,2,11
36,1,2,1,2,2,2,10
41,2,2,2,2,2,2,12
42,1,2,2,2,2,2,11
53,2,2,1,2,2,2,11
57,2,2,2,2,2,2,12
63,1,1,1,2,2,2,9
98,1,2,2,2,2,2,11
124,2,2,2,2,1,1,10
135,2,2,2,2,2,1,11
169,1,2,2,2,2,1,10
170,1,2,1,2,2,2,10
176,1,2,2,2,1,2,10
192,1,2,1,2,2,2,10
198,2,2,2,2,2,2,12
201,2,2,2,2,2,2,12
207,2,1,2,1,2,1,9
211,1,1,1,2,2,2,9
215,2,1,2,2,2,1,10
221,1,2,2,2,1,1,9
236,2,2,1,1,2,2,10
246,2,2,1,2,2,2,11
258,1,1,1,2,1,1,7
260,1,2,2,2,1,1,9
325,2,2,2,2,2,2,12
364,1,1,1,1,1,1,6
417,2,2,2,2,2,2,12
418,2,2,2,2,2,2,12
423,1,2,2,2,2,2,11
438,2,2,2,2,2,1,11
449,2,2,2,2,2,2,12
463,1,1,1,2,2,2,9
485,1,2,2,2,2,2,11
487,1,2,1,1,2,2,9
489,2,2,2,2,2,2,12
491,2,2,2,2,2,1,11
501,1,1,2,1,2,2,9
530,1,1,1,1,1,1,6
562,1,1,1,2,1,1,7
590,1,2,1,2,2,2,10
591,2,1,1,1,2,1,8
620,1,2,2,2,1,2,10
621,1,2,2,2,2,2,11
624,1,2,2,2,2,2,11
662,1,2,2,2,1,2,10
663,1,2,2,2,2,2,11
664,1,2,2,2,2,2,11
675,1,1,2,1,2,2,9
698,2,1,2,1,1,1,8
731,2,1,2,2,2,1,10
755,2,2,2,2,2,2,12
764,2,1,1,1,2,1,8
802,1,2,2,2,2,2,11
821,2,2,1,2,2,2,11
841,1,1,2,2,1,2,9
842,2,2,2,2,2,1,11
845,1,1,2,1,2,2,9
849,2,1,1,2,2,2,10
858,1,2,2,2,1,2,10
872,1,1,1,2,2,1,8
885,1,1,1,1,1,1,6
903,1,1,1,2,2,2,9
932,2,2,2,2,2,2,12
972,1,2,1,2,1,2,9
986,1,2,1,1,1,2,8
996,1,1,1,2,2,2,9
998,1,2,2,2,2,2,11
1020,1,2,2,2,2,2,11
1051,2,2,2,2,2,1,11
1087,1,1,2,1,1,1,7
1089,1,2,2,2,2,2,11
1105,1,2,1,2,2,1,9
1111,1,2,2,2,1,2,10
1113,1,2,2,2,2,2,11
1138,2,2,2,2,1,1,10
1144,2,2,2,2,2,2,12
1179,2,2,2,2,2,2,12
1195,1,2,2,2,2,2,11
1236,1,2,2,2,1,2,10
1266,2,2,2,2,2,2,12
1270,1,1,2,1,2,2,9
1327,1,2,1,2,2,1,9
1333,2,1,1,1,2,1,8
1344,1,2,1,2,1,1,8
1378,1,2,2,2,2,2,11
1394,1,2,2,2,2,1,10
1406,1,2,1,2,1,1,8
1420,2,1,2,2,1,2,10
1441,1,2,2,2,1,1,9
1446,1,1,1,2,1,1,7
1452,1,2,2,2,1,1,9
1468,2,2,2,2,2,2,12
1478,2,2,2,2,2,2,12
1528,1,2,1,1,2,1,8
1535,1,1,1,2,1,2,8
48,2,2,1,1,2,2,10
49,1,2,2,2,1,2,10
103,1,2,1,2,2,2,10
167,2,2,2,2,2,2,12
196,1,2,2,2,2,2,11
206,1,2,2,2,1,1,9
244,2,2,2,2,2,2,12
292,2,2,2,2,2,1,11
359,2,2,2,2,2,2,12
378,1,1,2,2,2,1,9
380,1,1,1,2,2,2,9
492,2,2,2,2,2,2,12
499,2,2,2,2,2,1,11
518,1,2,2,2,2,2,11
519,2,2,2,2,2,2,12
598,1,2,2,2,1,2,10
614,1,1,2,1,2,2,9
642,2,2,2,2,2,2,12
749,1,2,2,2,2,1,10
765,2,2,2,2,2,1,11
815,1,2,2,2,1,2,10
902,2,2,2,2,2,2,12
960,2,2,2,2,2,2,12
961,2,1,2,2,2,2,11
982,1,2,2,2,2,1,10
1052,2,2,1,2,2,2,11
1122,1,1,1,1,1,1,6
1128,2,2,2,2,2,2,12
1157,1,1,1,1,1,1,6
1163,1,2,2,2,2,2,11
1175,2,2,2,2,2,2,12
1186,2,2,2,2,2,2,12
1223,1,2,1,2,1,1,8
1228,1,2,1,2,1,2,9
1239,2,2,2,2,2,2,12
1322,2,2,2,2,2,1,11
1338,1,1,1,2,1,1,7
1341,2,2,2,2,2,2,12
1371,1,2,1,1,1,1,7
1383,1,2,2,2,1,2,10
1407,2,2,2,2,2,2,12
1429,1,1,1,2,1,2,8
1476,1,2,2,2,2,2,11
1493,1,2,2,1,2,2,10
1499,1,2,2,2,1,2,10
1508,1,2,1,2,1,2,9
1536,2,2,2,2,2,2,12
293,2,2,2,2,2,2,12
323,2,2,2,2,2,2,12
580,1,2,2,2,1,1,9
1010,1,2,2,2,1,1,9
1085,1,2,2,2,1,1,9
1280,2,2,2,2,2,2,12
1303,2,2,2,2,1,1,10
1474,1,2,2,2,1,2,10
56,1,1,1,2,1,1,7
695,1,1,2,2,1,1,8
988,2,2,2,1,2,2,11
1124,2,2,2,2,2,1,11
1350,1,2,1,2,1,1,8
1450,2,2,2,2,2,2,12
1511,1,2,2,2,2,1,10
91,1,1,2,1,2,1,8
101,2,2,2,1,2,1,10
130,2,2,2,2,1,2,11
186,1,2,2,2,2,2,11
393,2,2,2,2,2,2,12
407,2,1,1,1,2,1,8
428,1,2,2,2,1,1,9
543,1,2,1,2,2,2,10
561,1,2,2,2,2,2,11
605,2,2,2,1,2,2,11
630,1,2,2,2,2,2,11
686,2,2,1,2,2,1,10
713,2,2,2,2,2,2,12
730,1,2,2,2,2,1,10
839,1,2,1,2,1,1,8
949,1,2,1,2,2,2,10
1082,2,1,2,1,2,2,10
1094,1,2,1,1,1,1,7
1102,1,2,2,1,2,2,10
1275,2,1,2,1,1,1,8
1445,1,2,2,2,2,2,11
71,2,2,2,2,2,2,12
107,1,2,2,1,2,2,10
155,2,2,2,2,2,2,12
283,2,2,2,2,2,2,12
300,2,2,2,1,1,1,9
511,2,2,2,2,2,1,11
516,1,2,1,2,2,2,10
655,2,2,2,2,2,1,11
699,1,2,2,2,1,2,10
929,2,2,1,2,2,2,11
954,1,2,2,2,2,2,11
1148,2,2,2,2,2,2,12
1153,2,2,2,2,2,2,12
1169,2,2,2,2,2,1,11
1222,1,1,2,2,1,2,9
1283,2,2,2,2,1,2,11
1348,1,2,1,2,2,1,9
1504,1,1,2,2,1,1,8
1526,1,2,2,2,1,2,10
134,1,2,2,2,2,2,11
440,1,2,2,2,2,2,11
785,1,2,2,2,2,2,11
1214,1,2,2,2,2,1,10
1086,2,2,2,2,2,1,11
976,1,2,1,2,1,1,8
1288,2,1,1,1,1,1,7
119,1,2,2,2,1,1,9
132,1,1,1,2,2,1,8
430,2,1,1,1,1,1,7
772,2,1,1,2,2,2,10
957,2,2,2,2,2,2,12
1190,1,2,1,2,2,2,10
1205,2,1,1,1,1,1,7
171,1,1,1,2,1,1,7
208,2,2,2,2,2,2,12
473,1,2,2,1,1,2,9
570,1,2,2,1,2,2,10
690,1,2,2,2,1,1,9
1197,2,2,1,1,2,2,10
1332,1,2,2,2,2,2,11
1356,2,1,2,1,2,1,9
245,1,2,2,2,2,2,11
324,1,2,2,1,1,2,9
488,1,1,2,2,2,2,10
705,2,2,2,2,2,1,11
1088,1,2,1,2,1,2,9
1312,1,1,1,1,2,1,7
1325,1,2,1,2,2,1,9
719,1,2,2,2,1,1,9
798,2,1,2,1,2,1,9
933,1,1,1,1,1,1,6
1480,2,2,2,2,2,2,12
1232,2,2,1,2,2,2,11
738,1,2,2,1,1,2,9
1294,2,1,2,2,2,2,11
481,1,1,2,1,1,2,8
637,1,2,2,2,1,1,9
607,2,2,2,2,2,2,12
1428,1,1,2,1,1,2,8
1023,1,2,2,2,2,1,10
376,2,2,2,2,2,1,11
457,1,2,1,1,2,2,9
472,1,2,2,2,1,2,10
338,2,2,1,2,2,1,10
387,1,2,2,2,2,2,11
887,1,1,1,1,1,1,6
1213,2,2,1,2,2,2,11
1414,2,2,2,2,2,1,11
66,1,2,2,2,2,2,11
38,2,2,1,2,2,2,11
43,1,1,1,1,1,1,6
734,2,2,2,2,2,2,12
909,2,2,2,1,2,2,11
525,2,2,2,2,2,2,12
1248,2,2,2,2,2,2,12
832,1,2,2,2,1,1,9
